1 1 1 1 1 1 1 1 1 1 1 1 1 1 1 1 1 1 1 1 1
1 21 21 11 1 1 1 1 1 1 1 1 1 1 1 1 1 1 1 11 1
1 2 1 1 1 1 1 1 1 1 1 1 1 1 1 1 1 1 21 12 21
1 1 1 1 1 1 1 1 12 1 1 1 1 1 1 1 1 1 1 1 1 1
1 1 1 1 1 1 1 1 1 1 1 1 1 1 1 11 1 1 11 1 1 1
1 31 0 0 1 1 1 1 13 1 1 1 1 1 1 1 1 1 1 1 1
1 0 0 0 1 1 1 1 1 1 1 1 1 1 1 1 1 1 1 1 1
1 0 0 0 1 1 1 11 1 14 1 1 1 1 1 1 1 1 1 1 1
1 1 1 1 1 1 1 2 1 1 1 1 1 1 1 2 1 1 1 1 1
1 1 1 1 1 1 1 3 1 1 1 1 1 1 1 1 1 1 1 1 1 1
1 1 1 1 15 1 1 1 1 1 1 1 1 1 1 1 1 1 11 1 1 1
1 1 1 1 1 1 1 1 1 1 1 1 1 1 1 1 1 1 1 1 1
1 1 1 1 1 1 1 1 1 13 14 15 1 1 1 1 1 1 1 1 1
1 1 1 1 1 1 1 1 1 1 21 21 1 1 1 1 1 12 1 1 1
1 1 1 1 1 1 1 1 1 1 21 21 1 1 1 1 1 1 1 1 1
32 0 0 1 1 1 1 21 22 1 1 1 1 1 1 1 1 1 31 0 0
0 0 0 1 11 1 1 1 1 1 1 1 1 1 1 1 1 1 0 0 0
1 1 1 11 1 1 1 1 1 1 1 1 1 1 1 12 1 1 0 0 0
1 1 1 1 1 1 13 1 1 14 1 1 1 1 1 1 1 1 1 1 1
21 1 1 1 1 1 1 1 1 1 1 1 1 12 1 1 21 1 1 1 1