1 1 1 1 1 1 1 1 1 1 1 1 1 1 1 1 1 1 1 10 1
1 2 3 4 5 6 1 1 1 1 1 1 1 1 1 1 1 1 1 16 1
1 1 1 1 1 1 1 1 1 1 1 1 1 1 1 1 1 1 28 22 23
1 1 1 1 1 1 1 1 1 1 1 1 1 1 1 1 1 1 1 1 1 1 
1 1 1 1 1 1 1 1 1 1 1 1 1 1 1 1 1 1 11 1 1 1
1 31 32 33 1 1 1 1 1 1 1 1 1 1 1 1 1 1 1 1 1
1 34 35 36 1 1 1 1 1 1 1 1 1 1 1 1 1 1 1 1 1
1 37 38 39 1 1 1 18 1 1 1 1 1 1 1 1 1 1 1 1 1
1 1 1 1 1 1 1 24 1 1 1 1 1 1 1 1 1 1 1 1 1
1 1 1 1 1 1 1 30 1 1 1 1 1 1 1 18 1 1 1 1 1 1
1 1 1 1 1 1 1 1 1 1 1 1 1 1 1 24 1 1 11 1 1 1
1 1 1 1 1 1 1 1 1 1 1 1 1 1 1 30 1 1 1 1 1
1 1 1 1 1 1 1 1 1 13 14 15 1 1 1 1 1 1 1 1 1
1 1 1 1 1 1 1 1 1 19 20 21 1 1 1 1 1 1 1 1 1
1 1 1 1 1 1 1 1 1 25 26 27 1 1 1 1 1 1 1 1 1
1 1 1 1 1 1 1 2 3 4 5 6 1 1 1 1 1 1 31 32 33
1 1 1 1 1 1 1 1 1 1 1 1 1 1 1 1 1 1 34 35 36
1 1 1 1 1 1 1 1 1 1 1 1 1 1 1 1 1 1 37 38 39
1 1 1 1 1 1 1 1 1 1 1 1 1 1 1 1 1 1 1 1 1
8 9 1 1 1 1 1 1 1 1 1 1 1 1 2 3 4 5 6 1 1